2002000300000000000000000000000230000000000000000000000020003003;map35
0000000000000000000002000000010000100000003000000000000000000000;map33
0000000000000000000120000002100000013000000310000000000000000000;map38
0000000000000000301001020000000000000000301001020000000000000000;map14
0000000021100000000000000000000000000000000000000000011300000000;map4
2000000000000000000001000000100000010000001000000000000000000003;map16
0000000000000000000001000000113000002110000001000000000000000000;map34_unused
0000000000000000003110000010000000000100000112000000000000000000;map30
0300030000101000000100000000000000000000000100000010100002000200;map36
0000000000000000000000000000000012100131010000100000000000000000;map17
0000000020200000011000000001000000001000000001100000030300000000;map42
1200000020000000000000000001100000011000000000000000000300000031;map1
2000000000000000000110000000100000010000000110000000000000000003;map19
0000000000000000000110000012310000132100000110000000000000000000;map15
0000000000000000001201000001100000011000001031000000000000000000;map18
0000000000000000002101000010100000010100001013000000000000000000;map7
0000000022200000111001000000000000000000001001110000033300000000;map28
1000000000000000002011000001000000001000001103000000000000000001;map41
1000000000000010001221000030030000300300001221000100000000000001;map21
1000000103000000001001000000000000000000001001000000002010000001;map34
2000000000000000000110000010010000100100000110000000000000000003;map12
2000000200000020001331000013301001022100001221000300000030000003;map29
3203303200000000230220231010101001010101320330320000000023022023;map23_unused
0000000000201100001000000010010000000100001103000000100000000000;map14_unused
0000000000000000001021000011010000101100001301000000000000000000;map11
0000000001200100001010000000010000100000000101000010031000000000;map8
0001000002101200000001000100000001000000000001000310130000010000;map40
0000000000000000121010100000000110000000010101310000000000000000;map10
2100000010000000000000000111000000001110000000000000000100000013;map27
0000000000011000001231000001100000100100001001000001100000000000;map4_unused
0000000000311000001001000010010000011000001021000100001000000000;map13_unused
0000000000011000001001000010010002111130001001000000000000000000;map5
0000000001000013001010010100000000000010100101002100001000000000;map45
0000000000100100001001000100001021000013010000100000000000011000;map44
0000022001101001000100001000000010000000000100000110100100000330;map43
2000000200100100011001100000000000000000011001100010010030000003;map2
3100000003010100000000100101000000001010010000000010102000000012;map25
0000000000111100001200000011200000031100000031000011110000000000;map3
0013331000131310000101000000000000000000000101000012121000122210;map37
0000000010000001010110100012310001011010100000010000000000000000;map6
1300002101000010010000100001000000001000010000100100001013000021;map23
0000000001001010001201000101100000011010001031000101001000000000;map9
0031300000111000000000001100001111000011000000000011100000212000;map33_unused
1300303101101100100000010000000000000000100000010110110012002021;map31
1000000100000000110000112010010320100103110000110000000010000001;map32
1000000110000001100000012100001321000013100000011000000110000001;map39
2002200210011001200220021001100110011001300330031001100130033003;map27_unused
0000000031111100000000100011001001001100010000000011111200000000;map22
0310001033100011110100000010100000010100000010111100012201000120;map26
3000000011111100000000100010101001010100010000000011111100000002;map20
1122221100111100000000001100001111000011000000000011110011333311;map24
2000000100000100000000100000100000010000010000000010000010000003;connexion
0000000000000000000000000000000000000000000000000000000020000003;Nom du terrain
3000000003000000001001000010010000100100001001000000002000000002;demonstration
3000000003000000001001000010010000100100001001000000002000000002;demo!
0000000000000000000002000000010000100000003000000000000000000000;corentin
0000000000000000003110000010222000000100000112000000000000000000;Nom du terrainiytyt